Team,Total Comments,Positive,Percent Positive,Negative,Negative Percentage
atlantahawks,4452,3293,74,1159,26
bostonceltics,107853,71904,67,35949,33
gonets,12763,8957,70,3806,30
charlottehornets,9587,6678,70,2909,30
chicagobulls,32824,24351,74,8473,26
clevelandcavs,73041,49951,68,23090,32
detroitpistons,22584,15134,67,7450,33
pacers,15836,10500,66,5336,34
heat,32552,20649,63,11903,37
mkebucks,57735,36989,64,20746,36
nyknicks,63193,42788,68,20405,32
orlandomagic,17487,13147,75,4340,25
sixers,74307,48840,66,25467,34
torontoraptors,64461,43741,68,20720,32
washingtonwizards,10934,7511,69,3423,31
mavericks,10896,8211,75,2685,25
denvernuggets,39517,26374,67,13143,33
warriors,48261,30885,64,17376,36
rockets,29459,19323,66,10136,34
laclippers,13455,8751,65,4704,35
lakers,130567,86351,66,44216,34
memphisgrizzlies,5456,3814,70,1642,30
timberwolves,33631,22538,67,11093,33
nolapelicans,8720,5720,66,3000,34
thunder,39252,25909,66,13343,34
suns,28915,19921,69,8994,31
ripcity,26078,17763,68,8315,32
kings,16679,11765,71,4914,29
nbaspurs,19576,14022,72,5554,28
utahjazz,19290,13821,72,5469,28
